

NO ./texture/pics/greystone.xpm
SO ./texture/pics/bluestone.xpm
WE ./texture/pics/colorstone.xpm
EA ./texture/pics/purplestone.xpm

F 255,255,255
C 0,0,255

111111111
100000001
100100001
100000101
100000101
100001101
100000101
100N00101
111111111