NO ./texture/pics/greystone.xpm
SO ./texture/pics/bluestone.xpm
WE ./texture/pics/colorstone.xpm
EA ./texture/pics/purplestone.xpm

F 255,255,255
C 0,0,255


11111111111111111111111111111111111111111111111111111111111111
10000000000000000000000000000000000000000000000000000000000001
10000000011111111111111111111111111111111111111111111000111111
11111100011111111                                   10001111
11111100000000001                   11111111111111111100000111111
11111111111100001                  100000000000000000000001100001
111111111110000011111111111111111111011111011100000111111100100011
111100000000000000000000000000000000000000000111111      110001111
11000010000000000000001000000001111111111111011          11111111
111111111111111110000000E00000000011111111100001     
1111111111110000000000000000000000000000000000001
1111111111111111111111111111111111111111111100011
1111111111111111111111111111111111111111111100011
1111111111111111111111111111111111111111111111011
1111111111111111111111111111111111111111111111111