NO ./path_to_the_north_texture
SO ./path_to_the_south_texture
WE ./path_to_the_west_texture
EA ./path_to_the_east_texture

F 220,100,0
C 225,30,0


11111111111111111111111111111111111111111111111111111111111111
10002000000000000000000000000000000000000000000000000000000001
10000000011111111111111111111111111111111111111111111111111111
11111100011111111
11111100000000001
11111111111100001
1111111111100000111111111111111111111111111111
1111000000000000000000000000000000000000000001
11000010000000000000001000000001111111111111011
111111111111111110000000E00000000011111111100001     
1111111111110000000000000000000000000000000000001
1111111111111111111111111111111111111111111100011
1111111111111111111111111111111111111111111100011
1111111111111111111111111111111111111111111111011
1111111111111111111111111111111111111111111111111