NO ./path_to_the_north_texture
SO ./path_to_the_south_texture
WE ./path_to_the_west_texture
EA ./path_to_the_east_texture

F 255,255,255
C 0,0,255



        1111111111111111111111111
        1000000000110000000000001
        1011000001110000000000001
        1001000000000000000000001
111111111011000001110000000000001
1000000000110S0001110111111111111
111101111111110111000000000011
111101111111110111010100100001
110000001101010111000000100011
10000000000000001100000010001
10000000000000001101010010001
11000001110101011111011110001
11110111 1110101 101111010001
11111111 1111111 111111111111