NO ./path_to_the_north_texture
SO ./path_to_the_south_texture
WE ./path_to_the_west_texture
EA ./path_to_the_east_texture

F 255,255,255
C 0,0,255

111111111111111111111111111111
100000000000100000100000000001
101111101110101110101111110101
101000101000101000101000010101
101010101011101010101011010101
101010101000001010001001010001
101010101111111011101101011101
100010000000000000000001000101
111011111011111110111101110111
100000001000000010000000010001
101111101111111011111111011101
101000101000001010000001010001
101010101011101010111101011101
101010101000101010000101000101
101010101110101011110111110101
101000100010001000010000010101
111110111011111011110111010101
100010001000000010000100010001
101011101111111011111101111101
101000100000001010000001000001
101110111111101010111111011111
100010000000101010000000010001
111011111110111011111111011101
100000000010000000000001000101
101111111011111111111101110111
100000001000000000000100000001
111111101111111111110111111101
100000000000000000000E00000001
111111111111111111111111111111