NO ./texture/pics/greystone.xpm
SO ./texture/pics/greystone.xpm
WE ./texture/pics/eagle.xpm
EA ./texture/pics/eagle.xpm
DO ./texture/pics/bluestone.xpm
VI ./texture/pics/skeleton.xpm

11111111111111111111111111111111111111111111111111111111111
10000000000000000000000000000000000000000000000000000000001
100000000000000000000000000000000000000000000000000000000011111111111111111111111111111
100000000000000000000000000000000000000000000000000000000000000000000000000000000000001
100000000000000000000000000000000000000000000000000000000011111111111111111111111000011
100000000000000000000000T0000000000000000000000000000000001                     100001
10000000000000000000000000000000000000000000000000000000001                     100001
10000000000000000000000000000000000000000000011100000000001                     100001
10000000000000000000000000000000000000000000110100000000001                     100001
10000000000000000000000000000000000000000001100100000000001                     100001
10000000000000000000000000000000000000000001100100000000001     111111111111111110000111111111111111111111111
1000E000000000000000000000000000000000000001000100000000001     100000000000000000000000000000000000000000001
1000000000000000000000V000000000000000000001000100000000001     100000000000000000000000000000000000000000001
10000000000000000000000000000000000000000000000000000000001     100000000000000000000000000000000000000000001
10000000000000000000000000000000000000000000000000000000001     100000000000000000000000000000000000000000001
10000000000000000000000000000000000000000000000000000000001     100000000000000000001D11111111000000000000001
100000000000000111111111111111111111D1111111111111000000001     100000000000000000001000000001000000000000001
10000000000000010000000000000000000000000000000001000000001     100000000000000000001000000001000000000000001
10000000000000010000000000000000000000000000V00001000000001     10000000000000000000111111D111000000000000001
100000000000000D0000000000000000000000000000000001000000001     100000000000000000000010000000000000000000001
10000000000000010000000000000000000000000000000001000000001     100000000000000000000010000000000000000000001
10000000000000010000000000000000000000000000000001000000001     100000000000000000000010000000000000000000001
10000000000000010000000000000000000000000000000001000000001     10000000000V000000000010000000000000000000001
10000000000000010000000000000000000000000000000001000000001     100000000000000000000010000000000000000000001
100000000000000100000000000000000000000000000000010000000011111110000000000000000000001000000000T000000000001
1000000000000001000000000T00000000000000000000000100000000000000000000000000000000000010000000000000000000001
1000000000000001000000000000000000000000000000000D00000000000000000000000000000000000010000000000000000000001
1000000000000001000000000000000000000000000000000100000000111111100000000000000000000010000000000000000000001
10000000000000010000000000000000000000000000000001000000001     100000000000000000000000000000000000000000001
10000000000000010000000000000000000000000000000001000000001     100000000000000000000010000000000000000000001
10000000000000011111111111D11111111111111111111111000000001     100000000000000000000010000000000000000000001
10000000000000000000000000000000000000000000000000000000001     100000000000000000000010000000000000000000001
10000000000000000000000000111111111100000000000000000000001     111111111111111111111111111111111111111111111
10000000000000000000000000100000000100000000000000000000001
10000000000000000000000000100000000100000000000000000000001
10000000000000000000000000100000000100000000000000000000001
10000000000000000000000000100000000100000000000000000000001
10000000000000000000000000000000000000000000000000000000001
11111111111111111111111111111111111111111111111111111111111