NO ./texture/pics/greystone.xpm
SO ./texture/pics/bluestone.xpm
WE ./texture/pics/barrel.xpm
EA ./texture/pics/eagle.xpm
FL ./texture/pics/purplestone.xpm
CE ./texture/pics/redbrick.xpm
DO ./texture/pics/wood.xpm

111111111111111111111111111111111
100000000000000000000000000000001
100000000000000000000000000000001
100000000000000000000000000000001
100000000000000000000000000000001
100000000000000000000000000000001
100000000000000000000000000000001
100000000000000000011100000000001
100000000000000000010100000000001
1000T0000000000001110100000000001
100000000000000001110100000000001     111111111111111111111111111
1000S0000000000000010100000000001     100000000000000000000000001
100000001000000000010100000000001     100000000000000000000000001
100000000100000000000000000000001     100000000000000000000000001
100000000010000000000000000000001     100000000000000000000000001
100000000000000000000000000000001     1000000000111D1100000000001
10000000000000011111D111000000001     100000000010000100000000001
100000000000000100000001000000001     10000T000010000100000000001
10000000000000010000000D000000001     10000000001D11D100000000001
100000000000000D00000001000000001     100000000000100000000000001
100000000000000100000001000000001     100000000000100000000000001
100000000000000111111D11000000001     100000000000100000000000001
100000000000000000000000000000001     100000000000100000000000001
100000000000000000000000000000001     111111111111111111111111111
100000000000000000000000000000001
111111111111111111111111111111111