NO ./texture/pics/greystone.xpm
SO ./texture/pics/bluestone.xpm
WE ./texture/pics/barrel.xpm
EA ./texture/pics/eagle.xpm
FL ./texture/pics/purplestone.xpm
CE ./texture/pics/redbrick.xpm
DO ./texture/pics/wood.xpm

111111111111111111111111111111111
100000000000000000000000000000001
100000000000000000000000000000001
100000000000000000000000000000001
100000000000000000000000000000001
100000000000000000000000000000001
100000000000000000000000000000001
100000000000000000011100000000001
100000000000000000010100000000001
1000T0000000000001110100000000001
1000000000000000011101000000000011111111111111111111111111111
1000N00000000000000101000000000011100000000000000000000000001
10000000000000000001010000000000111000T0000000000000000000001
1000000001100000000000000000000011100000000000000000000000001
1000000001100000000000000000000011100000000000000000000000001
10000000000000000000000000000000111000000000111D1100000000001
1000000000000001111D11110000000011100000000010000100000000001
10000000000000010000000D0000000011100000000010000100000000001
1000000000000001000000010000000011100000000011111100000000001
100000000000000D000000010000000011100000000000000000000000001
1000000000000001000000010000000011100000000000000000000000001
100000000000000111111D11000000001 100000000000000000000000001
100000000000000000000000000000001 100000000000000000000000001
100000000000000000000000000000001 111111111111111111111111111
100000000000000000000000000000001
111111111111111111111111111111111
1111111111111111111111111111111111
1000000000000000000000000000000001
10000000000000000000000000000T0001
1000000000000000000000000000000001
1000000000000001111111111100000001
1000000000000001000000000D00000001
1000000000000001000000000100000001
1000000000000001000000000100000001
1000000000000001000000000100000001
10000000000000011D1111111100000001
1000000000000000000000000000000001
1000000000000000000000000000000001
1000000000000000000000000000000001
1000000000000000000000000000000001
1000000000000000000000000000000001
1000000000000000000000000000000001
1111111111111111111111111111111111