NO ./texture/pics/greystone.xpm
SO ./texture/pics/bluestone.xpm
WE ./texture/pics/barrel.xpm
EA ./texture/pics/eagle.xpm
DO ./texture/pics/wood.xpm
VI ./texture/pics/skeleton.xpm

1111111111
100E000001
1000000001
100000E001
100S000001
1000000001
1111111111