NO ./texture/greystone.xpm
SO ./texture/bluestone.xpm
WE ./texture/barrel.xpm
EA ./texture/eagle.xpm
DO ./texture/wood.xpm
VI ./texture/skeleton_1.xpm
V2 ./texture/skeleton_2.xpm
V3 ./texture/skeleton_3.xpm

11111111111111
10000000000001
100000V0000001
10000000000001
10000111110001
10000000000001
10000000000001
10000000000001
1000N000000001
10000000000001
11111111111111