NO ./texture/pics/greystone.xpm
SO ./texture/pics/bluestone.xpm
WE ./texture/pics/barrel.xpm
EA ./texture/pics/eagle.xpm
FL ./texture/pics/purplestone.xpm
CE ./texture/pics/redbrick.xpm
DO ./texture/pics/wood.xpm

111111111111111111111111111111111
100000000000000000000000000000001
100000000000000000000000000000001
100000000000000000000000000000001
100000000000000000000000000000001
100000000000000000000000000000001
100000000000000000000000000000001
100000000000000000011100000000001
100000000000000000010100000000001
1000T0000000000001110100000000001
10000000000000000111010000000000111111111111111111111111
1000N000000000000001010000000000111000000000000000000001
10000000000000000001010000000000111000000000000000000001
10000000011000000000000000000000111000000000000000000001
10000000011000000000000000000000111000000000000000000001
1000000000000000000000000000000011100000000000T000000001
1000000000000001111D111100000000111000000000000000000001
10000000000000010000000D00000000111000000000000000000001
10000000000000010000000100000000111000000000000000000001
100000000000000D0000000100000000111000000000000000000001
10000000000000010000000100000000111111111111111111111111
100000000000000111111D11000000001
100000000000000000000000000000001
100000000000000000000000000000001
100000000000000000000000000000001
111111111111111111111111111111111
1111111111111111111111
1000000000000000000001
1000000000000000000001
1000000000000000000001
1001111110000000000001
1001000DD000T000000001
1001111110000000000001
1000000000000000000001
1000000000000000000001
1000000000000000000001
1111111111111111111111