

NO ./texture/pics/greystone.xpm
SO ./texture/pics/bluestone.xpm
WE ./texture/pics/colorstone.xpm
EA ./texture/pics/purplestone.xpm

F 255, 255,255
C 0,0, 0

111111111111111111111111111111111
100000000000000000000000000000001
100000000000000001111100000000001
100000000000000001111100000000001
1000N0000000000000011100000000001
100000000000000000011100000000001
100000000110000000000000000000001
100000000110000000000000000000001
100000000000000000000000000000001
100000000000000111101111000000001
100000000000000100000000000000001
100000000000000100000001000000001
100000000000000000000001000000001
100000000000000100000001000000001
100000000000000111111011000000001
100000000000000000000000000000001
100000000000000000000000000000001
100000000000000000000000000000001
100000000000000000000000000000001
100000000000000000000000000000001
100000000000000000000000000000001
100000000000000000000000000000001
100000000000000000000000000000001
100000000000000000000000000000001
100000000000000000000000000000001
100000000000000000000000000000001
100000000000000000000000000000001
111111111111111111111111111111111