

NO ./texture/pics/greystone.xpm
SO ./texture/pics/bluestone.xpm
WE ./texture/pics/colorstone.xpm
EA ./texture/pics/purplestone.xpm

F 255,255,255
C 0,0,0

1111111111111111111111111111111111111
1000000000000000000000000000000000001
1000000000000000000000000000000000001111111111111111111
1000000000000000000000000000000000000000000000000000001
1000000000000000000000000000000000001111111111111000011
1000000000000000000000000000000000001           100001
1000000000000000000000000000000000001           100001
1000000000000000000000110100000000001           100001
1000000000000000000001100100000000001           100001
1000000000000000000001100100000000001     111111100001111111
1000S00000000000000001000100000000001     100000000000000001
1000000000000000000000000000000000001     100001111111111001
1000000000000001111111111111000000001     100001000000001001
1000000000000001000000000001000000001     100001000000001001
1000000000000001000000000000000000001     100001111111111001
1000000000000000000000000001000000001     100000010000000001
1000000000000001000000000001000000001     100000010000000001
100000000000000100000000000100000000111111100000010000000001
100000000000000100000000000100000000000000000000010000000001
100000000000000100000000000100000000000000000000010000000001
100000000000000100000000000100000000111111100000010000000001
1000000000000001000000000001000000001     100000010000000001
1000000000000001111111111111000000001     100000010000000001
1000000000000000000000000000000000001     111111111111111111
1000000000000000000000000000000000001
1000000000000000000000000000000000001
1000000000000000000000000000000000001
1111111111111111111111111111111111111