NO ./texture/pics/colorstone.xpm
SO ./texture/pics/colorstone.xpm
WE ./texture/pics/colorstone.xpm
EA ./texture/pics/colorstone.xpm

F 255,255,255
C 0,0,255

1111111111
1000000001
1010000001
1000000001
1000S00001
1000000001
1000000001
1000001001
1000000001
1111111111