NO ./texture/pics/colorstone.xpm
SO ./texture/pics/colorstone.xpm
WE ./texture/pics/bluestone.xpm
EA ./texture/pics/bluestone.xpm

F 255,255,255
C 0,0,255

11111111111
10000000001
10000000001
10110000001
10000000001
10000000001
10000000001
100N0001001
10000000001
11111111111
